1524664694
1617345414
2966632441
2996822910
3040766508
