1187304676
1224162951
1782818779
2196442123
2619089296
3385637036
3693692540
3951166642
3982968490
