1372740343
1688552332
1752455588
2190611032
2217716169
2652227638
3148024741
416824492
