1335391615
1524664694
1617345414
2365407795
2966632441
2996822910
3040766508
3751360870
853904245
