1296281716
1312679284
1651594091
1660445409
1876266063
1961051499
21805470
2187564186
2267246242
246603166
2525316106
2606024044
2927786992
3048693215
3078125171
3284814941
3366255854
3622844450
3644822609
3704167071
3927271073
3947220442
4272421323
4281910033
4545074
742899241
837859020
