1160813668
1188775418
1208664330
134966494
1652042180
1653128555
1698441973
2472925057
2602381775
2653204982
2911934235
3103317940
3153233132
3230439176
3518002119
3739719192
3880521876
3935100643
4233474292
7495396
