1428777203
2207707860
2484537346
26941641
2912925056
3855054593
4040309676
640697518
