1674131097
2525852228
3020147085
3146881440
3424584524
612213931
688897718
762394830
