1002102973
1451129311
2272838343
2845932414
3778755728
