1484834254
1961741924
2942324612
2995766278
3304915969
3686655593
431556018
661234939
