1067571600
116929552
1185230324
1377194964
1413481797
1532214882
1639925498
1743319719
1947237537
1954235738
2370572820
2571239565
2595833992
2597886222
264143795
2676386243
2682701297
2765158578
2777584233
302428376
3125010545
3268590479
3278286435
3310768555
3437137685
3489688702
3546499896
3548275828
3565069496
3713145916
3756247731
376753964
3878426035
3967699237
4083094741
4153856956
4178699545
4187220217
517075308
581791882
625382799
831644821
864678188
941495062
997554101
