1294752196
1356446930
1512766213
1529671191
1950172881
2115182374
2251007605
2867286877
3259689412
3274936979
3709303353
