1000080336
1349950120
1589260458
2101100912
2370929336
2915705625
3431898488
3869369060
3986442933
