1018744905
1030727847
1070103084
1109976999
1203868849
1491512434
1954404532
2027765951
2108113514
2191184749
2381353582
2501942952
268284555
270982231
2896610992
3264473991
3408336884
360102733
3603538026
3788476664
3841654332
3862579444
3870787892
3900071293
3977585331
3999608043
4002197541
4002282748
4077422903
4099073570
4104945749
4160768694
420889058
4258546861
537556207
579101951
582784511
74539663
900485099
