1166208107
1457315110
1543685745
1772842208
2600898993
2874695382
2899005324
2940636647
2958235982
2983579339
3298741039
3373617022
3566254495
3585799920
3826527558
3964221964
4023983405
4261069602
699250060
719704660
