1027699248
1543180474
1569756580
1585638245
1617889084
1625333615
2067683882
2207441041
2314350352
2390977176
244963303
2992440017
3068527709
3223743194
3733669631
3757898272
3851873989
4235507892
434274300
717829147
