1349950120
1589260458
1844800111
2101100912
2370929336
2915705625
3378537991
3431898488
4110786590
