1212036343
130013711
1318871561
1359319073
1432575297
1500598728
1740008416
1765791264
1986105535
2089880893
2171852662
2843117399
2897171089
2947177820
3174064820
3177717099
3216228771
3303629141
3367416181
3426958462
3477440391
3507722409
3578637368
3634304615
3730088489
3746368226
3874245230
3948704464
4051394455
4099651128
4204374590
688169733
