1021978317
1683046182
1967014602
2477731840
2622036105
2672432648
2680134554
3178768047
4226239307
