1167322036
1187304676
1224162951
1295471782
1702551403
1782818779
2196442123
2619089296
3033085316
3385637036
3431476194
3526356622
3693692540
3811239806
3839748498
3951166642
3982968490
4108008889
