1335391615
1524664694
1617345414
2966632441
2996822910
3751360870
