1031188262
1404824883
1427048289
1866988581
2286261420
2298639351
2587105558
2623161001
2948653019
39164580
