1257250750
1331162169
1353883947
3307100841
3488978202
