1780795321
1828200088
2135435473
2503363796
2586585700
2748055648
4279109197
532276455
