1166654913
2604705577
3210576771
3438134328
3474504373
3728801305
