1036636719
2456032918
2679254926
298594335
3755719699
4145594538
4162497094
815865188
