1138342536
1638688472
1821486735
2009244035
3220384043
3673459244
538311216
785364890
