21805470
2187564186
2267246242
2525316106
2927786992
3048693215
3078125171
3284814941
3704167071
3927271073
3947220442
4272421323
742899241
