1249454862
1449194021
2136871801
2765659410
2872108562
2881298790
3765393665
4196949943
4251920496
819081908
850832751
