1545112831
1926716912
2812868841
3038412392
3729599498
381549436
3815494574
451027962
