1074961763
1105537468
1195059826
1313218109
1442752728
14649523
1607470760
1608834188
1749853882
1991748213
2218144136
2255154104
2433796351
2454414056
2465287367
2578878477
2646649592
2697700277
2891186805
2939080058
3063906643
3234482253
3363471433
3421577570
358909458
399165742
4017948226
4132096661
4268115532
53075685
598725653
611545182
710897278
711255649
