1000080336
1589260458
1844800111
2101100912
2370929336
2915705625
3986442933
4110786590
