1647607507
1858125858
3264454528
3311269746
3498990070
3804243776
4151775857
854268649
