1020266092
151871090
1834708528
2173563505
2804144694
3420449413
811308894
