1082632211
2432509921
2696691471
2968786965
304237788
3332384453
4230942764
