1762454277
2529237966
2740127656
2823310798
2964598921
3494954450
3771663164
3907444367
