1607467018
1680892928
1863164713
3470804720
3800193665
4114200228
4222725746
4229500501
