1660445409
21805470
2187564186
2525316106
2927786992
3284814941
3366255854
3622844450
3704167071
742899241
