1184369266
1301055349
1367597181
1578227482
1741197663
2039749522
2221610997
22363613
2305297469
2666543292
3213464621
3239600242
3266556514
3461974481
3562252906
4275646603
48577542
615636164
82032667
958046878
