1917782551
2204286344
2553552794
2794581433
29418033
3163113615
4004336473
721995315
