1000080336
1349950120
1589260458
1844800111
2370929336
2696437207
2915705625
3378537991
3431898488
3869369060
3986442933
4110786590
