1092438784
1179540444
124768101
1259432907
1484787836
1655556153
1672648208
1946123127
2011753701
2523728641
2579756498
2847981681
2888762391
3950181940
4042316407
4211659545
