1005597779
1347512339
1624708534
1649785780
1916581990
3169864767
3887797475
