1334968611
1540546568
1902527357
2235029794
2383622689
2794845140
3908673753
923387451
