1349981514
1780795321
1828200088
2268612194
2503363796
2586585700
3161591756
4279109197
532276455
