124768101
1946123127
2523728641
2847981681
2888762391
4211659545
