1147023504
1492634338
1535856619
1622369906
1652443796
2297201079
2343211966
2922897653
3522030512
3737841784
