1150067604
1470308616
1498845759
1499575656
1736758217
2125929012
2341519319
2368923211
306191661
623772961
