1056320051
1056320052
1056320053
1056320054
3953814368
3953814369
3953814377
3953814378
3953814379
3953814380
3953814381
3953814382
3953814383
3970591963
