1032360877
1144661622
1659866733
2605290998
3499489899
3693152932
3969551254
4220998318
