1372294634
1909950151
2443880838
3102447627
3401847161
3418339161
3430375624
529218448
