1523272309
1560769609
1722802377
2077401701
2171229349
2594473670
2634268294
2679731994
2985368938
3033784627
3196235692
3334703038
3363123621
3780624567
3996953352
4127004710
4275679554
486698172
81103251
923168288
