1179540444
1259432907
1484787836
1655556153
1946123127
2011753701
2523728641
2579756498
3950181940
4042316407
4211659545
